5 15 1 1
# # # # . . . # . . . # # # #
# # # # . . . # . . . # # @ #
# # # # # # # # # # # # # # #
. . . . . . # G # . . . . . .
. . . . . . # # # . . . . . .
13 1 2 1 2 1 12 
