10 15 13 1
. . . . . . . . . . . # # # #
. # # # # # # # o # # # # # #
. # # # # . . . . . . . # # #
. # # o # . . . . . . . . . .
. # # # # . . . . . . . . . .
. . . # # # o # # # # # # . .
. . . . . . . . . . # # # # o
# # # . . . . . . . # # # # #
# G # # # # # # # # # # # . .
# # # # . . . . . . . . . . .
8 1 2 1 6 1 5 0 0 
3 3 2 8 5 8 6 1 0 
6 5 2 8 5 8 6 1 0 
14 6 2 8 5 8 6 0 1 
