6 15 1 4
. . . . . . # # # # . . # # #
# # # # . . # # x # . . # G #
# # o # . . # # # # . . # # #
# # # # . . # # # # . . # # #
# # # # . . # # # # . . # # #
# # # # . . # # # # . . . . .
2 2 2 4 4 4 5 0 0 
8 1 2 4 10 4 11 0 0