10 15 0 3
. . . . . # # # # # # . . . .
. . . . . # . . # # # . . . .
. . . . . # . . # # # # # . .
# # # # # # . . . . . # # # #
. . . . # # # . . . . # # G #
. . . . # # # . . . . . # # #
. . . . . . # . . # # . . . .
. . . . . . # # # # # . . . .
. . . . . . # # # # # . . . .
. . . . . . . # # # . . . . .