8 15 1 3
. . . . . . . . # # # # . . .
. . . . . . . . # # # # . . .
# # # . . . . . # . . # # # #
# # # # # # # # # . . . # G #
# # # . . . . # # x . . # # #
# # # . . . . # # # . . # # #
. # # . . . . # . . . . . . .
. . # # # # # # . . . . . . .
9 4 1 6 3 0 1 
