10 13 2 6
. . . . . . . . . . . . x
. . . . . # # # . . # # #
. . . . . # x # # # # # .
. . . # # # # # . . # # .
. . . # G # . . . . # # .
. # # # # # . . . # # # #
# # # # . . . . . # # # #
# # # # . . # # # # # . .
. . . . . # # # . . . . .
. . . . . # # # . . . . .
6 2 1 2 12 0 0 
12 0 1 4 6 0 1 
