10 14 4 2
. . . . . . . . # # # . . .
. . . # # # . . # # # . . .
# . . # # # # # # # # # # #
# . . # # # . . . . . . x #
# . . . . . . . . . . . # #
# . . . . . . . . . . . # #
# . . . . . . . # # # # # #
# # # # # . . . # # # . . .
. # # G # . . . # # # . . .
. . # # # . . . # # # # # x
13 9 2 3 1 3 2 0 1 
12 3 2 2 1 2 2 0 1 
