10 15 1 8
. . . . . . . # # # . . # # #
. . . . # # # # # # . . x # #
# # . . # . . # # # . . # # #
# # # # # . . . o . . . . . .
# # . . . . . . . . . . . . .
. # . . . . . @ . . . . . . .
. # . . . . . # . . . . . . .
# # # . . . # # # . . o # # .
# # # # # # # # # # # # G # .
# # # . . . # # # . . o # # .
7 5 2 8 1 1 13 
11 7 2 8 9 8 10 0 0 
11 9 2 8 9 8 10 0 0 
8 3 5 1 6 1 10 1 11 1 0 0 
12 1 5 1 6 1 2 2 2 3 0 1 
