10 15 1 0
. # # # # # # # # # o # # # #
. . . . . # # . . . . . . # #
. . . . . # # . . . . . . # #
. . . . . . . . . . . . . # #
. . . . . . . . . . . . . # #
# # # . . # # . . # o # # # #
# G # . . # # . . . . . . . .
# # # . . # # . . . . . . . .
. # # . . # # . . . . . . . .
. # # # # # # # # # o # # # .
10 0 2 7 5 8 5 0 1 
10 5 2 9 2 9 3 1 0 
10 9 2 9 2 9 3 0 1 
