10 14 9 1
# # # . . . . . # # # # # #
# G # . . # . . # # # # @ #
# # # . . . . . # # # # . .
. . . . . . . . . # # # . .
. . . . . . . . . . . # # .
. . . . . . . . . . . . # .
. . . . . . . . . . . . # .
. . . . . . . . . . . # # .
. . . . # # # # # . . # # .
. . . . # o . . # # # x # .
12 1 2 1 12 1 9 
11 9 4 1 6 1 7 2 12 3 12 0 0 
5 9 2 1 3 1 4 0 1 
