9 15 2 3
. . . . . . . o . . . . . . .
# # o # . . . # . . . . . . .
# # # # # . . # . . . . . . .
# o # # # # # # . . # # . . #
# # # # # . . . # . . . # . .
# # o # . . . . # . . . # . .
# . . . . . . . o . . # # # .
# . . . . . . . . . # # G # .
# . . x . . . . . . # # # # .
1 3 2 8 3 9 3 0 0 
2 1 4 12 3 13 3 1 8 2 8 0 0 
2 5 4 12 3 13 3 1 8 2 8 0 0 
7 0 2 8 3 9 3 0 1 
8 6 4 12 3 13 3 1 8 2 8 0 1 
3 8 1 4 5 0 1 
