10 15 1 1 
# # # . . . . . . . . . . . .
# # # # # # # # # . . . # # #
# # # . . . . . # # # # # G #
# # # . . . . . . . . . x x #
# # # . . . . . . . . . . . .
# # # . . . . . . . . . . . .
# # # . . . . # # # # # x . .
# # # # # # # # . . . # # . .
# o # . . . . . . . . # # . .
# # # . . . . . . . . # x . .
1 8 1 8 7 0 1 
12 6 1 7 2 0 1 
12 9 2 7 8 9 1 0 0 
12 3 1 6 6 1 0 
13 3 1 6 6 0 1 
