10 14 12 3
# # # = # # # # = # # # # .
# # . . . . . . . . # # # .
# # . . . . . . . . . # # #
# # # . . . # # # . . # # #
# # # = = = # G # . . # # #
# # # . . = # # # . . # . .
. . # . . = = = = = # # . .
. . # # # = = # = = = . . .
. . . # # = = = = = = . . .
. . . # # # . . # # . . . .
