10 14 1 7
. . # # . . . . . . . . . .
. . # # # . . . . . . . . .
. . # # o . . . . . # # # .
. . . # # # # . . . # G # .
. . . . . . # # . . # # # .
. # # . . . # # . . . . . .
# # x # # # # # . . . . . .
# # # . . . # # . . . # # #
# # # . . . # # o # # # # #
. . . . . . . . . . . # # #
2 6 2 8 4 9 4 0 1 
8 8 2 6 4 6 5 0 1 
4 2 4 8 4 9 4 13 2 13 3 0 0 
