10 14 1 3
. . . . . # # . . . . # # #
. . . # # # # # # . . # G #
# # # # # # o # # # # # # #
# # # # o . . # # # # # . .
# # # . . . . . . # # # . .
. # . . . . . . . . # . . .
. # . . . . . . . . # . . .
. # . . . . . . . # # . . .
. # # . . . . . . # # . . .
. . x . . . . . . x . . . .
4 3 2 2 7 12 3 1 0 
6 2 2 2 7 12 3 1 0 
9 9 1 2 7 0 1 
2 9 1 12 3 0 1 