9 14 10 5 
. . . . . # # # # . . . . @
. . . . . # # o # # # . . #
. . . . # # # # # # # . . #
# # # # # # # # . . # # # #
# # # . . . # . . . # # . .
# # # . . . # . . . # . . .
. # . . . . # # # . . . . .
. x . . . . # G # . . . . .
. . . . . . # # # . . . . .
7 1 2 2 3 3 3 0 0 
13 0 2 3 12 5 10 
1 7 2 3 4 9 7 0 0 