10 15 2 2
. # # # # # # . . . . . . . .
. # # . . # # # . . . . . . .
= = # . . # # # # . . . . . .
= = . . . . . # # # . . . . .
= = . . . . . . # # # . . . .
= # # # . . . . . # # @ . . .
. # G # . . . . . . # # # # #
. # # # # # # . . . # o # # #
. . # . . # # . . . # # # . .
. . # . . # # # # # # # # . .
11 7 4 3 0 4 0 8 9 9 9 1 0 
11 5 2 6 14 9 12 
