10 15 8 2
. . . . . . . . . . . . # # #
. . # # # # # # # # . . # # #
. . # # # . . o # # . . # # #
. . # # # . . # # # . . . . .
. . # o # . . @ # o . . . . .
. . # # # . . # # # . . . . .
# # # # . . . # # # . . o # #
# o . . . . . . . . . . # # #
. . . . . . . . . . . . # G #
. . . . . . . . . . . . # # #
7 2 2 5 1 6 1 0 0 
9 4 2 5 1 6 1 0 0 
7 4 2 13 1 13 7 0 0 
12 6 2 10 6 11 6 0 0 
3 4 2 5 1 6 1 0 0 
1 7 2 10 1 11 1 0 1 
