10 15 4 7
. # # # . . . . . . . . # # #
. # x # . . . . . . . . # o #
. # # # . . . # # # # # # # #
. # # # . . . # G # . . # # #
# . . . # . . # # # . . . . #
o . . . # . . = = = . . . . #
# . . # # # = = = = = # # # #
. . . # # # = = = = = # @ # .
. . . # # # = = = = = # # # .
. . . # # # # # . . . . . . .
12 7 2 7 12 2 2 
13 1 3 9 8 1 6 2 6 0 1 
0 5 3 6 2 6 1 0 3 0 0 
2 1 1 4 3 0 1 
