10 15 1 3
. . . . . . . . # # . . . . .
. . . . . . . # # # . . . . .
# # . . # # # # # # . . . . .
# # # # # # . . # . . . . . .
# # # # . . . . # . . . # # #
. # # . . . . . x # # # # G #
. . # . . . . . x # . . # # #
. . # # # . . . # # . . . . .
. . . # # # . . # # . . . . .
. . . . # # # # # # . . . . .
8 5 1 3 9 0 1 
8 6 1 5 7 0 1 
