10 15 1 1
# # # . . . . # # # # # # # #
# # # # # # # # # # # . . # #
# # # . . . . # # . . . . # #
. . . . . . . . . . . . # x #
. . . . . . . . . . . . # # .
# # # . . = = = = # . . o o .
# G # = = = = = = = . . # # #
# # # = = = = = = = = = # # #
. . . . . = = = = = = = # # #
. . . . . . # # # # . . . . . 
13 3 0 2 9 6 9 9 0 
12 5 1 6 9 1 0 
13 5 0 1 9 9 0 
