8 14 1 2
. . . . . . . . . . # # # #
. . . . # # # # # # # x # @
. # . . # x # . . . # # # #
x # . . # # . . . . . . # .
# # . . # . . . . . . . # .
# # # # # . . . . . # # # .
# # # . . # # # . . # G # .
. . . . . x # . . . # # # .
0 3 1 3 1 0 1 
11 1 2 2 2 2 3 0 1 
5 2 1 7 7 0 1 
13 1 2 6 5 6 7 
5 7 2 6 8 6 9 0 1 
