10 15 2 4
. . . # # # # # = = # # # # .
. . . # G # # . . . . . = # .
. . . # # # . . . . . . = # x
. . . . . . . = # # # # # # #
. . # . . . . = = . . . . . #
. x # = . . . = = . . . . . #
= = = = . . . # # . . . . # #
= = = # = # = = # = . . x # .
# = = = = = = = = = = = # . .
. = # = = = . . = = = = # . .
1 5 2 10 3 11 3 0 1 
12 7 1 14 7 0 0 
14 2 4 11 3 10 3 12 6 9 6 0 0 
