10 15 12 7
. . . . . . . . . . . # # # .
. # # # . . . . x . . # G # .
. # # # # # # # # . . # # # .
. # # # . . # # # . . . # . .
. = = = . . o # # . . . = . .
. . = . . . # # # . . = = = .
. . # . . . # # # . . # # # .
# # # # . . # o # # # # # # .
# # x # . . x . . . . # # # .
# # # # . . . . . . . . . . .
7 7 0 8 2 4 2 5 2 9 2 10 7 4 7 5 7 9 7 10 0 
6 4 0 8 2 4 2 5 2 9 2 10 7 4 7 5 7 9 7 10 0 
6 8 2 4 7 5 7 0 0 
8 1 2 9 2 10 2 0 0 
2 8 5 4 2 5 2 14 0 14 1 14 2 0 0 
