9 14 10 6
. . . . . . . . . . . . # x
. . # # # # # # . . . # # #
. # # # . . # # . . # x # #
. # G # . . . # # # # # . .
. # # # . . . . # # # . . .
. . . . . . . . . # # . . .
. . . . # # # . . # # . . .
# # . . # x # . . # # . . .
# # . . # # # # # # # . . .
11 2 2 2 8 3 9 0 0 
13 0 4 2 7 3 7 4 1 5 1 0 0 
5 7 2 4 2 5 2 0 0 